Abkhaz	N
Alamblak	Y	f
Arapesh	Y	um,ma
Babungo	Y	e,ke
Bambara	Y	j,m
Basque	Y	ze,no
Berbice Dutch	Y	w-,h-
Boraana Oromo	Y	ee
Desano	Y	dV,CV?V
Garo	N
Georgian	N
Guarani	Y
Gude	Y
Hittite	Y
Hixkaryana	N
Hungarian	N
Hunza Burushaski	N
Imbabura Quechua	Y
Itelmen	N
Japanese	Y
Kayardild	N
Ket	Y
Kisi	Y
Koasati	Y
Kombai	Y
Krongo	N
Lango	Y
Mandarin Chinese	Y
Miao	N
Mundari	Y
Nama	Y
Nasioi	Y
Navajo	N
Ngalakan	N
Ngiti	Y
Nivkh	Y
Nung	N
Nunggubuyu	N
Paiwan	N
Pipil	Y
Polish	N
Samoan	Y
Sumerian	Y
Tagalog	Y
Tamil	Y
Tidore	N
Turksih	N
Tuscarora	Y
Warao	Y
West Greenlandic	Y